NO ./img/N.xpm
SO ./img/S.xpm
WE ./img/W.xpm
EA ./img/E.xpm

F 102,204,204
C 192,192,192

1111111111111111
1010000000000001
1010000010000001
1010000000000101
10100100W0010101
1010000000000101
1000000010000101
1000000000000101
1111111111111111