NO ./img/N.xpm
SO ./img/S.xpm
WE ./img/W.xpm
EA ./img/E.xpm

F 204,255,204
C 204,229,255

111111111111111
100000000000001
1111111D1111111
101000000000101
101000101000101
101000000000101
10D0000N0000D01
101000000000101
101000000000101
101000000000101
1111111D1111111
100000000000001
111111111111111